type octile
height 20
width 32
map
................................
.@@@@@@..@@@@@@..@@@@@@..@....@@
.@@@@@@..@@@@@@..@@@@@@..@....@@
.........................@@.....
.@@@@@@..@@@@@@..@@@@@@..@....@@
.@@@@@@..@@@@@@..@@@@@@..@....@@
.........................@@.....
.@@@@@@..@@@@@@..@@@@@@..@....@@
.@@@@@@..@@@@@@..@@@@@@..@....@@
.........................@@.....
.@@@@@@..@@@@@@..@@@@@@..@....@@
.@@@@@@..@@@@@@..@@@@@@..@....@@
.........................@@.....
.@@@@@@..@@@@@@..@@@@@@..@....@@
.@@@@@@..@@@@@@..@@@@@@..@....@@
.........................@@.....
.@@@@@@..@@@@@@..@@@@@@..@....@@
.@@@@@@..@@@@@@..@@@@@@..@....@@
.........................@@.....
.@@......@@......@@......@@...@@
